ADITHYA ACADEMY OF ARCHITECTURE & DESGIN	1AN
AKSHAYA INSTITUTE OF TECHNOLOGY	1AK
ALPHA COLLEGE OF ENGINEERING	1AC
AMRUTHA INSTITUTE OF ENGINEERING AND MGMT. SCIENCES	1AR
ATRIA INSTITUTE OF TECHNOLOGY	1AT
B.T.L.INSTITUTE OF TECHNOLOGY	1BT
BEST SCHOOL OF ARCHITECTURE	1TA
BGS SCHOOL OF ARCHITECTURE & PLANNING	1PC
C BYEREGOWDA INSTITUTE OF TECHNOLOGY	1CK
Dr. Sri Sri Sri SHIVKUMAR MAHASWAMY	1CC
DR. T THIMAIAH INSTITUTE OF TECHNOLOGY	1GV
EAST POINT COLLEGE OF ENGG. FOR WOMEN	1EC
EAST POINT COLLEGE OF ENGINEERING AND TECHNOLOGY	1EP
GOPALAN SCHOOL OF ARCHITECTURE & PLANNING	1GO
GOVERNMENT TOOL ROOM AND TRAINING CENTRE	1GT
IMPACT COLLEGE OF ENGINEERING	1IC
IMPACT SCHOOL OF ARCHITECTURE	1IS
K S SCHOOL OF ARCHITECTURE	1KF
KALPATARU INSTITUTE OF TECHNOLOGY	1KI
KNS INSTITUTE OF TECHNOLOGY	1KN
NANDI INSTITUTE OF TECHNOLOGY MANAGEMENT SCIENCES	1AU
P N S INSTITUTE OF TECHNOLOGY	1PN
R.L.JALAPPA INSTITUTE OF TECHNOLOGY	1RL
R.R. SCHOOL OF ARCHITECTURE	1RR
R R INSTITUTE OF TECHNOLOGY	1RI
SAI VIDYA INSTITUTE OF TECHNOLOGY	1VA
SAMBHRAM INSTITUTE OF TECHNOLOGY	1ST
SAMPOORNA INSTITUTE OF TECHNOLOGY RESEARCH	1 SZ
SCT INSTITUTE OF TECHNOLOGY	1SC
SEA COLLEGE OF ENGINEERING AND TECHNOLOGY	1SP
SHASHIB COLLEGE OF ENGINEERING	1HS
SHRI PILLAPPA COLLEGE OF ENGINEERING	1PL
SHRIDEVI INSTITUTE OF ENGINEERING AND TECHNOLOGY	1SV
SRI REVANASIDDESHWARA INSTITUTE OF TECHNOLOGY	1RC
SRI VIDYA VINYAKA INSTITUTE OF TECHNOLOGY	1VG
SRI VINAYAKA INSTITUTE OF TECHNOLOGY	1VB
T. JOHN INSTITUTE OF TECHNOLOGY	1TJ
VEMANA INSTITUTE OF TECHNOLOGY	1VI
VIJAYA VITTALA INSTITUTE OF TECHNOLOGY	1VJ






<TR><TD>BMS EVENING COLLEGE OF ENGINEERING</TD><TD>	1BE</TD></TR>
<TR><TD>BMS INSTITUTE OF TECHNOLOGY	</TD><TD>1BY</TD></TR>
<TR><TD>BRINDAVAN COLLEGE OF ENGG	</TD><TD>1BO</TD></TR>
<TR><TD>C.M.R INSTITUTE OF TECHNOLOGY	</TD><TD>1CR</TD></TR>
<TR><TD>CAMBRIDGE INSTITUTE OF TECHNOLOGY	</TD><TD>1CD</TD></TR>
<TR><TD>CHANNA BASAVESHWARA INSTITUTE OF TECHNOLOGY	</TD><TD>1CG</TD></TR>
<TR><TD>CITY ENGINEERING COLLEGE	</TD><TD>1CE</TD></TR>



<TR><TD>SIDDAGANGA INSTITUTE OF TECHNOLOGY</TD><TD>	1SI</TD></TR>
<TR><TD>SIR M. VISVESVARAYA INSTITUTE OF TECHNOLOGY</TD><TD>	1MV</TD></TR>
<TR><TD>SJB INSTITUTE OF TECHNOLOGY</TD><TD>	1JB</TD></TR>
<TR><TD>SRI KRISHNA INSTITUTE OF TECHNOLOGY</TD><TD>	1KT</TD></TR>
<TR><TD>SRI SAIRAM COLLEGE OF ENGINEERING	</TD><TD>1SB</TD></TR>
<TR><TD>SRI VENKATESHWARA COLLEGE OF ENGINEERING	</TD><TD>1VE</TD></TR>
<TR><TD>VIVEKANANDA INSTITUTE OF TECHNOLOGY</TD><TD>	1VK</TD></TR>
<TR><TD>YELLAMMA DASAPPA INSTITUTE OF TECHNOLOGY	</TD><TD>1YD</TD></TR>


<TR><TD>PES INSTITUTE OF TECHNOLOGY</TD><TD>	1PI</TD></TR>
<TR><TD>PES SCHOOL OF ENGINEERING</TD><TD>	1PE</TD></TR>
<TR><TD>R.V.COLLEGE OF ENGINEERING</TD><TD>	1RV</TD></TR>
<TR><TD>RAJARAJESWARI COLLEGE OF ENGINEERING</TD><TD>	1RR</TD></TR>
<TR><TD>RAJIV GANDHI INSTITUTE OF TECHNOLOGY</TD><TD>	1RG</TD></TR>
<TR><TD>REVA INSTITUTE OF TECHNOLOGY & MANAGEMENT</TD><TD>	1RE</TD></TR>
<TR><TD>RNS INSTITUTE OF TECHNOLOGY</TD><TD>	1RN</TD></TR>
<TR><TD>S.J.C INSTITUTE OF TECHNOLOGY</TD><TD>	1SJ</TD></TR>
<TR><TD>SAPTHAGIRI COLLEGE OF ENGINEERING</TD><TD>	1SG</TD></TR>


<TR><TD>K.S SCHOOL OF ENGG & MGMT</TD><TD>	1KG</TD></TR>
<TR><TD>K.S.INSTITUTE OF TECHNOLOGY</TD><TD>	1KS</TD></TR>
<TR><TD>M.S.ENGINEERING COLLEGE</TD><TD>	1ME</TD></TR>
<TR><TD>M.S.RAMAIAH INSTITUTE OF TECHNIOLOGY</TD><TD>	1MS</TD></TR>
<TR><TD>MVJ COLLEGE OF ENGINEERING</TD><TD>	1MJ</TD></TR>
<TR><TD>NAGARJUNA COLLEGE OF ENGINEERING AND TECHNOLOGY</TD><TD>	1NC</TD></TR>
<TR><TD>NEW HORIZON COLLEGE OF ENGINEERING</TD><TD>	1NH</TD></TR>
<TR><TD>NITTE MEENAKSHI INSTITUTE OF TECHNOLOGY</TD><TD>	1NT</TD></TR>
<TR><TD>OXFORD COLLEGE OF ENGINEERING</TD><TD>	1OX</TD></TR>


<TR><TD>EAST WEST COLLEGE OF ENGG</TD><TD>	1EE</TD></TR>
<TR><TD>EAST WEST INSTITUTE OF TECHNOLOGY</TD><TD>	1EW</TD></TR>
<TR><TD>GHOUSIA COLLEGE OF ENGINEERING</TD><TD>	1GC</TD></TR>
<TR><TD>GLOBAL ACADEMY OF TECHNOLOGY</TD><TD>	1GA</TD></TR>
<TR><TD>GOPALAN COLLEGE OF ENGINEERING MANAGEMENT</TD><TD>	1GD</TD></TR>
<TR><TD>GOVERNMENT S.K.S.J.T. INSTITUTE OF TECHNOLOGY</TD><TD>	1SK</TD></TR>
<TR><TD>GOVERNMENT SKSJT EVENING COLLEGE</TD><TD>	1SE</TD></TR>
<TR><TD>GOVT. ENGINEERING COLLEGE RAMNAGAR</TD><TD>	1GG</TD></TR>
<TR><TD>HKBK COLLEGE OF ENGINEERING</TD><TD>	1HK</TD></TR>
<TR><TD>HMS INSTITUTE OF TECHNOLOGY</TD><TD>	1HM</TD></TR>
<TR><TD>ISLAMIAH INSTITUTE OF TECHNOLOGY</TD><TD>	1II</TD></TR>
<TR><TD>JNANA VIKAS INSTITUTE OF TENCNOLOGY</TD><TD>	1JV</TD></TR>
<TR><TD>JSS ACADEMY OF TECHNICIAL EDUCATION</TD><TD>	1JS</TD></TR>
<TR><TD>JYOTHY INSTITUTE OF TECHNOLOGY</TD><TD>	1 J</TD></TR>
